00000000000000000000
00100000001110000000
00010100101000000000
00010100101000000000
00010100101000000000
00010000101000000000
00010000001000000000
00011111001000000000
00010000001000000000
00011111111000000000
00000000000000000000
00000000000000000000
00000000000000000000
00000000000000000000
00000000000000000000
00000000000000000000
00000000000000000000
00000000000000000000
00000000000000000000
00000000000000000000
